11111111111111111111111111111111
1M0MM000MMMM0MMMMMMM0MMMMMPM0MM1
1M00MMMMM00MM000C00M00M00M0MMM01
1MM0MC000M00M0M0M00M00M0MMCM0M01
10M0MMM0MM0MM0M0MM0M0MM0M00M0MM1
1MM000M0M00M00M00M0MMM00MM0M0001
1M0MMMM0MMMMM0M00M000MMM000MMM01
1MMM0000000000MM0MMM00000M000MM1
1MMM00MM0MMMMM0M000MMMMM0MMM00M1
1000MMM00000000MMMM0000M000MM0M1
1MM0M0M0M0MMMMM000M0MMMM0M00M0M1
10M0M0MMM0M0M0000MM000M00MM0M0M1
1MM0M00000M0M0MMMM000MM00M00MMM1
1M000M0000M00MMM00M00M0000000MM1
10MM000MM0MMM00MM0MMMM0MMMM000M1
1M0000M0MC00M0M0MM0000MM00M0MMM1
1M0MCMM0MMM0M0M00MMMMMM000M0M001
1M0MM00MM000M0C000MMM0MM0MM0M0M1
1C00000M0MMMM0M00000000M0M00MMM1
1M0M0MMM000M00MMMM0MMM0M0MM000M1
1MMM0000000000MMMM0M0MM0000MM0M1
1M0M00MCM0MCM0MMMM00C000MM0CMEM1
11111111111111111111111111111111