11111111111111111111111111111111
11011000111101111111011111P10111
11001M1110011000C001001001011101
1110MC000M0010101001001011C10101
10101M101101101011010110100M0111
11100010M00100100101110011010001
11011110111110100100011100011101
11M1000000000011011M000001000111
11110011011111010001111101110011
10001110000000011110000100011011
11101010101111M00010111101001011
10101011101010000110001001101011
11101000001010111100011001001M11
11000100001001110010010000000111
10110001101110011011110111100011
110000101C0010101100001100101111
1101CM1011101010011M111000101001
110110011000M0C00011101101101011
1C000001011110100000000101001111
11010111000100111101110101100011
111100000000001MM101011000011011
1101001C101C10111100C000110C1E11
11111111111111111111111111111111