1111111111111
110P1100000C1
1C01E000M0001
110M1C0M1M0C1
100C0000M0001
1111111111111