1111111111111
10010C0000011
1001011111001
111P01101E001
1111111111111