11111111111
1000100C001
10010100001
10001000001
10P0000C001
10C00E00001
10000C00001
11111111111